MODE 0
SIZE 9/9
LIMIT 1/170
COLOR LIMIT 53
STARS 0/0/0
0 1 1 1 0 1 1 1 0
1 1 1 0 1 0 1 1 1
1 1 0 1 1 1 0 1 1
1 0 1 1 0 1 1 0 1
0 1 1 1 0 1 1 1 0
1 0 1 1 0 1 1 0 1
1 1 0 1 1 1 0 1 1
1 1 1 0 1 0 1 1 1
0 1 1 1 0 1 1 1 0