MODE 0
SIZE 7/6
LIMIT 0/25
COLOR LIMIT 25
STARS 0/0/0
0 1 1 1 1 1 0
1 1 1 1 1 1 1
1 1 1 0 1 1 1
1 1 1 1 1 1 1
1 1 1 1 1 1 1
0 1 1 0 1 1 0