MODE 0
SIZE 8/8
LIMIT 1/110
COLOR LIMIT 47
STARS 0/0/0
0 0 0 1 1 0 0 0
1 1 1 1 1 1 1 1
1 1 1 1 1 1 1 1
0 0 0 1 1 0 0 0
1 1 1 0 0 1 1 1
1 1 1 1 1 1 1 1
1 1 1 1 1 1 1 1
0 0 0 1 1 0 0 0