MODE 0
SIZE 8/8
LIMIT 1/120
COLOR LIMIT 44
STARS 0/0/0
0 1 1 1 1 1 1 0
0 1 1 1 1 1 1 0
1 0 1 1 1 1 0 1
1 1 0 0 0 0 1 1
1 1 0 0 0 0 1 1
1 0 1 1 1 1 0 1
0 1 1 1 1 1 1 0
0 1 1 1 1 1 1 0