MODE 0
SIZE 8/8
LIMIT 0/40
COLOR LIMIT 43
STARS 0/0/0
0 0 1 1 1 1 0 0
1 1 1 1 1 1 0 1
1 1 1 1 1 0 1 1
1 1 1 1 1 1 1 1
1 1 1 1 1 1 1 1
1 1 0 1 1 1 1 1
1 0 1 1 1 1 1 1
0 0 1 1 1 1 0 0