MODE 0
SIZE 6/8
LIMIT 0/30
COLOR LIMIT 53
STARS 0/0/0
1 1 0 0 1 1
1 1 1 1 1 1
1 1 0 0 1 1
1 1 1 1 1 1
1 1 0 0 1 1
1 1 1 1 1 1
1 1 0 0 1 1
0 0 1 1 0 0