MODE 0
SIZE 7/9
LIMIT 0/50
COLOR LIMIT 53
STARS 0/0/0
0 1 1 1 1 1 0
0 1 1 1 1 1 0
0 1 1 1 1 1 0
1 0 1 1 1 0 1
1 1 0 1 0 1 1
1 1 1 0 1 1 1
1 1 0 1 0 1 1
1 0 1 1 1 0 1
0 1 1 1 1 1 0